#####################
#             #     #
############# # ### #
#           #   #   #
# ######### ##### ###
# #       # #   # #
# # ##### # ### # # #
# #   # # # #   #   #
# ### # # # # # ### #
# #   # # #   #   # #
# # ### # ##### ### #
# #   #   #     #   #
# ### ##### ##### ###
#   # #       #   # #
### # # ##### # ### #
#   # # #   # # #   #
# ### # # # ### ### #
# #     # #     #   #
# ####### ####### # #
#                 #
#####################
